############
#      P   #
#  UU      #
#  # ##    #
#  x  #    #
#       U# #
#  ###x  #x#
############